1111111111111111111111111111111111111110111111111111111111111111111111111111111
1000000000000000000010000010001000000000100000100000100000001000100000000010001
1011111111111011111110101010101011111010101010111010111011101011101011111011101
1010000000100010000000101010100010000010101010100010000010000010001010000000001
1010111111101110111111101010111110111110111010101111111111111110111011111111111
1010100000101000100010001010100010001000000010001000100000000010101000001000001
1010101110101011111010101110101011101111111011111010101111111010101111101011101
1000100010101000001010101000101000100010001010000010101010000010001000100000101
1110111010101111101010101011101010111010101110111110101010111011101011111111101
1000001010100000100010101000101010001000100000001000100010100010001000000010001
1011111010111010111010111110101011111111111111111011111010111110111011111010111
1000100010100010001010100000101010001000000010001000100010100000101010001010001
1111101110101011111010101111101010101011111010101110101110101111101010101011111
1000001000001010000010100000101000100000100010100000101010001000000010101000101
1011111111111010111110111110101111111011101010111110101011111111101110111010101
1010000000001010000010000010100010001010001010000010101000000000101000100010101
1010111111101111111011101110111010101110111011111011101111111010101010101110101
1010000010100000001010001000100010101000100010100010001000001010100010101010101
1011111010111011111010101011111110101011101110101110111011101010111111101010101
1000000010001000000010101000100010100010101000101000100010001010100000001010001
1011111110101111111110111110101010111110101010101011101110111010101111111011101
1000000000100000000010000000001000100000000010100000001000000010001000000000001
1111111111111111111111111111111111111110111111111111111111111111111111111111111