10111111111111
10111110001011
10000000100011
11101110111111
11100110000011
11111111111011